#,#,#,#,#,#,#,#,#,#,#,#,#,#,#,#,#,#,#,#,#,#,#,#,#
#,-e,-,-,-,-,-,-,-,-,-,-,-,-,-,-,-,-,-,-,-,-,-,+,#
#, , , , , , , , , , , , , , , , ,t, , , , , , ,#
#, , , , ,X, , , , , , , , , , , , , , ,t, , , ,#
#, , , , , , , , , , , , , , , , , , ,#,#,#,#,#,#
#, , , , , , , , , , , , , , , , , , ,#, , , , ,#
#, , , , , , , , , , , , , , , , , , , , , , , ,#
#, , , , , , , , , , , , , , , , , , , , , , , ,#
#, , , , , , , , , , , , , , , , , , , , , , , ,#
#, , , ,o, , , , ,o, , , , , , , ,o, , , ,O, , ,#
#,#,#,#,#,#,#,#,#,#,#,#,#,#,#,#,#,#,#,#,#,#,#,#,#
